0,16
1,32
2,64
4,8
5,256
.
4,4,4,4,4,4,4,4,4,4,4,4,4,4,4,4,4,4,4,4
4,1,5,5,5,5,5,5,5,5,5,5,5,1,1,1,1,1,1,4
4,2,5,1,1,1,5,1,1,1,1,1,5,1,1,5,5,5,1,4
4,5,5,5,5,5,5,5,5,5,5,5,5,5,5,5,1,5,1,4
4,4,4,4,4,4,0,0,0,5,1,1,1,5,1,5,1,5,1,4
4,4,4,4,4,4,0,2,0,5,2,1,1,5,1,5,5,1,1,4
4,4,1,2,4,4,0,5,5,5,5,5,5,5,1,1,5,5,1,4
4,4,1,5,4,4,1,0,0,5,0,0,0,0,1,1,1,5,2,4
4,4,1,5,5,5,5,5,5,5,0,1,1,1,1,1,1,5,5,4
4,4,1,1,0,0,0,0,0,5,5,5,5,5,1,1,1,5,1,4
4,4,4,4,4,4,5,5,5,5,0,1,1,5,5,0,1,5,1,4
4,4,4,4,4,4,5,0,1,1,1,1,4,4,5,0,0,5,1,4
4,1,1,1,1,1,5,1,1,4,4,1,4,4,5,5,5,5,1,4
4,1,5,2,1,0,5,4,4,4,2,1,4,4,2,1,5,1,1,4
4,1,5,5,5,0,5,4,4,0,5,1,4,4,5,5,5,2,1,4
4,1,5,0,5,5,5,4,4,1,5,1,1,1,1,0,5,5,5,4
4,2,5,1,5,0,5,4,4,1,5,1,2,1,1,0,5,1,1,4
4,5,5,5,5,0,5,5,5,5,5,5,5,5,5,5,5,5,5,4
4,1,1,1,1,0,1,1,1,1,1,2,0,0,1,1,2,1,5,4
4,4,4,4,4,4,4,4,4,4,4,4,4,4,4,4,4,4,4,4
.